# Map file for tile-based game
# (Lines that start with '#' are comments)
# The tiles are:
#   (Space) Empty tile
#   A..Z    Tiles A through Z
#   o       Bubble
#   *       Goal
#   1       Bad Guy 1 (sucio)
                                                                 
                                                                                                               o
                                                                                                               C
                                                           o o o                                               C
        o o o                            o  o  o         AAAAAAAAAA                                     ooo    C
       AAAAAAA                        AAAAAAAAAAA           o  o  o                                    o   o   C
                AA        AAAA                                                                        o     o  C
                                                                 1           1                      EBF      o C
                                1                    1EBBBBBBBBBBBF          EBBBF1   o o  o o    EBGAD        C
BBBBBB      1       1  EBBBBBBBBF    1EBFooo  EBBBBBBBGAAAAAAAAAAAHF      EBBGAAAHBBBBBBBBBBBBBBBBGAAAD     *  C
BBBBBBBBBBBBBBBBBBBBBBBGAAAAAAAAHBBBBBGAHBBBBBGAAAAAAAAAAAAAAAAAAAAHBBBBBBGAAAAAAAAAAAAAAAAAAAAAAAAAAAHBBBBBBBBG